Maal=sexy lady
Tum=you
Mai=me
Bhai=brother
Ka=his
Ka-maal=product
Ek-number=awesome
Madarchod=motherfker
Hai=is
Kaisa hai= how are you
Chod raha hai= are you fucking?
Hawa=air
Bc=brilliant child
Bhenchod=brilliant child
Nai=no/not
Bhenchod=sister fucker
hum tum se pyaar karte h=i love you
chod dia = fuck you
mera lund chuso = suck my dick  
lage raho = keep doing  
Madar=mum
Chod=fuck
Madarchod=motherfuxker
bahut=very
khubsurat=beautiful
awadi=population
Ja raha hu=going to
randi = slut
lund= cock
dard = pain 
mera=in past

Kaise=how to
Hilana=fap
Sapne mat dekh=dum dream
sochal
tu=you all
lawda = penis
aaj = today
kaal = tomorrow
firse = once again
chutiya=rascal

baap=father
loda=penis
